,nationality,height,weight,gold,silver,bronze,medals,country
0,USA,1.787250923,74.30093458,117,51,67,235,United States
1,GER,1.789931193,74.14418605,46,43,66,155,Germany
2,GBR,1.773763736,72.61095101,56,54,25,135,United Kingdom
3,RUS,1.780333333,71.63320463,47,28,34,109,Russian Federation
4,CHN,1.762385787,69.46475196,42,28,34,104,China
5,FRA,1.786167076,73.4040404,18,53,21,92,France
6,AUS,1.784188862,73.51358025,23,33,23,79,Australia
7,ITA,1.778636364,70.73333333,8,39,24,71,Italy
8,CAN,1.759153605,70.07594937,3,4,61,68,Canada
9,JPN,1.704035088,64.75882353,14,12,35,61,Japan
10,SRB,1.850792079,80.5049505,13,26,13,52,Serbia
11,NED,1.793292181,72.39166667,9,24,13,46,Netherlands
12,BRA,1.765311828,72.90769231,34,7,5,46,Brazil
13,ESP,1.768506494,72.03921569,7,19,16,42,Spain
14,DEN,1.823046875,76.453125,15,10,16,41,Denmark
15,NZL,1.775812808,74.47783251,4,23,4,31,New Zealand
16,SWE,1.785766871,74.22839506,2,23,3,28,Sweden
17,JAM,1.757358491,72.41509434,8,16,1,25,Jamaica
18,CRO,1.871704545,86.88372093,7,15,2,24,Croatia
19,KOR,1.731394231,67.93596059,11,3,9,23,"Korea, Republic of"
20,ARG,1.779366516,75.72093023,21,1,0,22,Argentina
21,BEL,1.77537037,69.84259259,2,17,2,21,Belgium
22,RSA,1.753571429,69.50359712,2,5,13,20,South-Africa
23,HUN,1.794868421,76.25333333,9,3,7,19,Hungary
24,NGR,1.760526316,76.72413793,0,0,18,18,Nigeria
25,AZE,1.775357143,75.71111111,1,7,10,18,Azerbaijan
26,NOR,1.763125,72.66666667,0,0,18,18,Norway
27,ROU,1.768571429,70.49484536,4,2,11,17,Romania
28,KAZ,1.740980392,70.54444444,3,5,9,17,Kazakhstan
29,POL,1.811324786,76.78017241,3,3,10,16,Poland
30,CZE,1.80754902,75.56862745,1,2,11,14,Czechia
31,UKR,1.76039801,70.46666667,1,8,5,14,Ukraine
32,UZB,1.753823529,75.38596491,4,2,7,13,Uzbekistan
33,FIJ,1.770425532,80.7,12,0,0,12,Fiji
34,KEN,1.70472973,65.64864865,5,6,1,12,Kenya
35,BLR,1.772195122,73.01666667,1,4,7,12,Belarus
36,SUI,1.76,68.25490196,5,3,2,10,Switzerland
37,CUB,1.769663866,74.47272727,4,1,4,9,Cuba
38,TUR,1.757254902,71.28125,1,3,4,8,Turkey
39,IRI,1.818888889,80.90322581,3,1,4,8,Iran
40,SVK,1.8038,73.14,3,5,0,8,Slovakia
41,ETH,1.706,56.54285714,1,1,5,7,Ethiopia
42,GEO,1.77375,84.225,2,1,4,7,Georgia
43,BUL,1.7558,71.93617021,0,1,6,7,Bulgaria
44,MAS,1.694193548,64.58064516,0,6,1,7,Malaysia
45,LTU,1.854242424,82.88888889,0,2,5,7,Lithuania
46,COL,1.709337748,66.36054422,2,2,3,7,Colombia
47,PRK,1.609032258,59.19354839,2,3,2,7,"Korea, Democratic People's Republic of"
48,GRE,1.790543478,72.95652174,3,1,3,7,Greece
49,THA,1.696851852,67.87755102,2,2,2,6,Thailand
50,BAH,1.764736842,68.875,1,0,5,6,Bahamas
51,MEX,1.744920635,69.79166667,0,3,2,5,Mexico
52,TPE,1.701071429,66.83018868,1,0,4,5,Taipei
53,EST,1.804782609,79.04347826,0,0,4,4,Estonia
54,ARM,1.716875,78.7037037,1,3,0,4,Armenia
55,INA,1.682857143,66.25,2,2,0,4,Indonesia
56,SLO,1.792380952,76.07936508,1,2,1,4,Slovenia
57,IRL,1.751794872,68.81944444,0,3,0,3,Ireland
58,VEN,1.775176471,76.57333333,0,1,2,3,"Venezuela, Bolivarian Republic of"
59,EGY,1.773135593,76.79824561,0,0,3,3,Egypt
60,TUN,1.799655172,77.98214286,0,0,3,3,Tunisia
61,ALG,1.756323529,70.31666667,0,2,0,2,Algeria
62,IOA,1.7475,92.25,1,0,1,2,Inde
63,IND,1.701964286,66.27522936,0,1,1,2,India
64,CIV,1.774166667,67.3,1,0,1,2,Ivory Coast
65,ISR,1.730851064,65,0,0,2,2,Israel
66,VIE,1.663913043,59.13043478,1,1,0,2,Vietnam
67,AUT,1.774084507,70.52112676,0,0,2,2,Austria
68,MGL,1.691395349,70.30555556,0,1,1,2,Mongolia
69,BRN,1.707857143,60.53571429,1,1,0,2,Brunei Darussalam
70,BDI,1.72,58.55555556,0,1,0,1,Burundi
71,TJK,1.79,84.33333333,1,0,0,1,Tajikistan
72,GRN,1.82,71,0,1,0,1,Granada
73,UAE,1.705,71.5,0,0,1,1,United Arab Emirates
74,FIN,1.757358491,70.57692308,0,0,1,1,Finland
75,TTO,1.748214286,70.56,0,0,1,1,Trinidad and Tobago
76,DOM,1.717931034,62.48148148,0,0,1,1,Dominican Republic
77,SIN,1.6864,64.12,1,0,0,1,Singapore
78,PUR,1.774358974,66.78947368,1,0,0,1,Puerto Rico
79,KOS,1.735,63.875,1,0,0,1,Kosovo
80,MDA,1.776956522,80.65217391,0,0,1,1,"Moldova, Republic of"
81,PHI,1.650833333,61.54545455,0,1,0,1,Phiipines
82,POR,1.757894737,69.30526316,0,0,1,1,Portugal
83,JOR,1.7475,71.33333333,1,0,0,1,Jordan
84,QAT,1.839230769,83.21621622,0,1,0,1,Qatar
85,NIG,1.791666667,71.66666667,0,1,0,1,Nigeria
86,MAR,1.73244898,63.73170732,0,0,1,1,Morocco
87,GAM,,,0,0,0,0,Gambia
88,BOL,1.714166667,64.33333333,0,0,0,0,"Bolivia, Plurinational State of"
89,BOT,1.81,66,0,0,0,0,Botswanan
90,BRU,1.58,57.33333333,0,0,0,0,Burundi
91,GAB,1.741666667,75.33333333,0,0,0,0,Gabon
92,LCA,1.72,51.25,0,0,0,0,Saint Lucia
93,GBS,1.72,76,0,0,0,0,Guinea-Bissau
94,LAT,1.803666667,77.1,0,0,0,0,Latvia
95,LBR,,,0,0,0,0,Liberia
96,BIH,1.801818182,85.90909091,0,0,0,0,Bosnia and Herzegovina
97,LES,1.77,69,0,0,0,0,Lesotho
98,LIB,1.67,64,0,0,0,0,Liberia
99,BIZ,1.836666667,79.33333333,0,0,0,0,Belize
100,BEN,1.793333333,78.83333333,0,0,0,0,Benin
101,BHU,1.64,55,0,0,0,0,Bhutan
102,BER,1.74625,69.5,0,0,0,0,Bermuda
103,LUX,1.769,68.3,0,0,0,0,Luxembourg
104,BAR,1.801818182,74.81818182,0,0,0,0,Barbados
105,BAN,1.65,69,0,0,0,0,Banned
106,ASA,1.7675,75,0,0,0,0,American Samoa
107,ARU,1.742857143,68.71428571,0,0,0,0,Aruba
108,ANT,1.79625,73.5,0,0,0,0,Antilles
109,ANG,1.762307692,73.34615385,0,0,0,0,Angola
110,AND,1.712,64,0,0,0,0,Andorra
111,BUR,1.81,84.4,0,0,0,0,Burundi
112,CAF,1.634,64.25,0,0,0,0,Central African Republic
113,CAM,1.635,57.16666667,0,0,0,0,Cambodia
114,CAY,1.765,68.75,0,0,0,0,Cayennes
115,LIE,1.803333333,77.66666667,0,0,0,0,Liechtenstein
116,MHL,1.664,70.2,0,0,0,0,Marshall Islands
117,MAD,1.68,63,0,0,0,0,Madagascar
118,GUM,1.748,71.8,0,0,0,0,Guam
119,ESA,1.705,71,0,0,0,0,El Salvador
120,ALB,1.761666667,67.33333333,0,0,0,0,Albania
121,KIR,1.63,73.66666667,0,0,0,0,Kiribati
122,KGZ,1.716111111,72.64705882,0,0,0,0,Kyrgyzstan
123,IVB,1.65,69,0,0,0,0,British Virgin Islands
124,ISV,1.813333333,74.33333333,0,0,0,0,Virgin Islands
125,ISL,1.81625,79.375,0,0,0,0,Iceland
126,IRQ,1.795384615,74.88,0,0,0,0,Iraq
127,HON,1.783,77.96551724,0,0,0,0,Honduras
128,HKG,1.708157895,63.86842105,0,0,0,0,Hong Kong
129,HAI,1.741666667,83.16666667,0,0,0,0,Haiwai
130,GUY,1.635,63.16666667,0,0,0,0,Guyana
131,GUI,1.72,69.2,0,0,0,0,Guinea
132,MAW,1.642,59.4,0,0,0,0,Malawi
133,GUA,1.692857143,64.52380952,0,0,0,0,Guatamala
134,GHA,1.731428571,67.85714286,0,0,0,0,Ghana
135,KSA,1.697272727,63.27272727,0,0,0,0,Saudi Arabia
136,GEQ,1.665,59.5,0,0,0,0,Equatorial Guinea
137,LAO,1.734,60.2,0,0,0,0,Lao People's Democratic Republic
138,LBA,1.76,63,0,0,0,0,Libya
139,MON,1.773333333,71.33333333,0,0,0,0,Monaco
140,MNE,1.825,83.64705882,0,0,0,0,Montenegro
141,MLT,1.723333333,75.6,0,0,0,0,Malta
142,MLI,1.756666667,70.4,0,0,0,0,Mali
143,MKD,1.7,61.83333333,0,0,0,0,North Macedonia
144,MDV,,,0,0,0,0,Maldives
145,FSM,1.546,65,0,0,0,0,"Micronesia, Federated States of"
146,ZAM,1.766666667,67.5,0,0,0,0,Zambia
147,ERI,1.7125,56.75,0,0,0,0,Eritrea
148,ECU,1.699736842,65.18181818,0,0,0,0,Ecuador
149,SMR,1.748,75.6,0,0,0,0,San Marino
150,SLE,,78.5,0,0,0,0,Sierra Leone
151,SKN,1.775,73.83333333,0,0,0,0,Saint Kitts
152,SEY,1.758,75.44444444,0,0,0,0,Seychelles
153,RWA,1.625,68,0,0,0,0,Rwanda
154,PNG,1.71,68.85714286,0,0,0,0,Papua New Guinea
155,PLW,1.616,80.4,0,0,0,0,Palau
156,TKM,1.75,78.25,0,0,0,0,Turkmenistan
157,TLS,1.6,,0,0,0,0,Timor-Leste
158,NAM,1.704,57,0,0,0,0,Namibia
159,NCA,1.706,62,0,0,0,0,Nicaragua
160,NEP,1.63,59.28571429,0,0,0,0,Nepal
161,YEM,1.696666667,64.66666667,0,0,0,0,Yemen
162,VIN,1.755,60,0,0,0,0,Saint Vincent
163,VAN,1.766666667,70.33333333,0,0,0,0,Vanuatu
164,URU,1.767647059,72.11764706,0,0,0,0,Uruguay
165,PLE,1.68,58.5,0,0,0,0,Paleestine
166,NRU,1.625,73,0,0,0,0,Nauru
167,UGA,1.76,,0,0,0,0,Uganda
168,TUV,1.84,72,0,0,0,0,Tuvalu
169,OMA,1.67,77.33333333,0,0,0,0,Oman
170,TOG,1.58,53,0,0,0,0,Togo
171,PAK,1.722,76.6,0,0,0,0,Pakistan
172,PAN,1.686,82.44444444,0,0,0,0,Panama
173,PAR,1.739090909,71.81818182,0,0,0,0,Paraguay
174,PER,1.687931034,62.93103448,0,0,0,0,Peru
175,SEN,1.780909091,72.86363636,0,0,0,0,Senegal
176,SOL,1.65,58,0,0,0,0,Solomon Islands
177,SOM,,,0,0,0,0,Somalia
178,MTN,1.705,63.5,0,0,0,0,Mauritania
179,CPV,1.774,63.5,0,0,0,0,Cabo Verde
180,DMA,1.79,74,0,0,0,0,Dominica
181,DJI,1.735714286,64.85714286,0,0,0,0,Djibouti
182,CYP,1.788125,71.4375,0,0,0,0,Cyprus
183,MOZ,1.745,68.83333333,0,0,0,0,Mozambique
184,CRC,1.729,69,0,0,0,0,Costa Rica
185,COM,1.685,60.25,0,0,0,0,Comoros
186,COK,1.726666667,72.88888889,0,0,0,0,Cook Islands
187,COD,1.63,57,0,0,0,0,"Congo, The Democratic Republic of the"
188,CMR,1.749583333,73.5,0,0,0,0,Cameroon
189,CHI,1.736904762,69.14285714,0,0,0,0,Chile
190,CHA,1.73,51.5,0,0,0,0,Chad
191,CGO,1.748888889,82.25,0,0,0,0,Republic of the Congo
192,MRI,1.736,61.625,0,0,0,0,Mauritius
193,ROT,1.715,63,0,0,0,0,Refugees
194,AFG,1.736666667,74,0,0,0,0,Afghanistan
195,MYA,1.7,63.16666667,0,0,0,0,Myanmar
196,SAM,1.635,68,0,0,0,0,Samoa
197,TGA,1.777142857,79,0,0,0,0,Tonga
198,TAN,1.676666667,57.85714286,0,0,0,0,Tanzania
199,SYR,1.853333333,84.83333333,0,0,0,0,Syrian Arab Republic
200,SWZ,1.75,69.5,0,0,0,0,Eswatini
201,SUR,1.9,78,0,0,0,0,Suriname
202,SUD,1.736666667,68,0,0,0,0,Sudan
203,STP,1.68,57.33333333,0,0,0,0,Sao Tome and Principe
204,SSD,1.733333333,63.33333333,0,0,0,0,South Sudan
205,SRI,1.687777778,63.88888889,0,0,0,0,Sri Lanka
206,ZIM,1.676,62.65714286,0,0,0,0,Zimbabwe
207,USAS,1.787250923,74.30093458,0.357,51,67,0.716,United States_S
208,ESPS,1.768506494,72.03921569,0.146,19,16,0.875,Spain_S
